             
 # # # # # # 
 # # ### # # 
 # # # # # # 
 # #     # # 
     # #     
# ##     ## #
     # #     
 # #     # # 
 # # # # # # 
 # # ### # # 
 # # # # # # 
 # #     # # 
 # # ### # # 
     # #     