                                       
                                       
                                       
   ###   ###   ###   ###   ###   ###   
   ###   ###   ###   ###   ###   ###   
   ###   ###   ###   ###   ###   ###   
   ###   ###   #########   ###   ###   
   ###   ###   #########   ###   ###   
   ###   ###   #########   ###   ###   
   ###   ###   ###   ###   ###   ###   
   ###   ###   ###   ###   ###   ###   
   ###   ###   ###   ###   ###   ###   
   ###   ###               ###   ###   
   ###   ###               ###   ###   
   ###   ###               ###   ###   
               ###   ###               
               ###   ###               
               ###   ###               
###   ######               ######   ###
###   ######               ######   ###
###   ######               ######   ###
               ###   ###               
               ###   ###               
               ###   ###               
   ###   ###               ###   ###   
   ###   ###               ###   ###   
   ###   ###               ###   ###   
   ###   ###   ###   ###   ###   ###   
   ###   ###   ###   ###   ###   ###   
   ###   ###   ###   ###   ###   ###   
   ###   ###   #########   ###   ###   
   ###   ###   #########   ###   ###   
   ###   ###   #########   ###   ###   
   ###   ###   ###   ###   ###   ###   
   ###   ###   ###   ###   ###   ###   
   ###   ###   ###   ###   ###   ###   
   ###   ###               ###   ###   
   ###   ###               ###   ###   
   ###   ###               ###   ###   
   ###   ###   #########   ###   ###   
   ###   ###   #########   ###   ###   
   ###   ###   #########   ###   ###   
               ###   ###               
               ###   ###               
               ###   ###               